0000011001410000
0000111111111100
0001101101111110
0001211100111010
0011111100113110
0011101111111111
0001100111111101
0000131111001111
0001111111111140
0001111001111110
0000111021101100
0000011111001100